t . . . . . . . . . . . . . . t
. . . . . . . . . . . . . . . .
. . . . . . . . . . . . . . . .
. . . . . . . . . . . . . . . .
. . . . . . . . t . . . . . . .
. . p p . . . . t . . . . . . .
. . p p . . . . . . . . . . . .
. . . . . . . . . . . . . p p .
. . . . . . . . . . . . . . . .
. . . . . . . . t . . . . . . .
. . p p . . . . . . . . . . . .
. . . . . . . . . . . . . . . .
